adobe	adobe
albaricoque	albaricoque
almagre	almagre
almendra	almendra
amarillo pálido	amarillo
amatista	amatista
ámbar	ámbar
ante	ante
añil	añil
arena	arena
aureolina	aureolina
avellana	avellana
azafrán	azafrán
azul claro	azul
barbecho	barbecho
beis	beis
bermejo	bermejo
bisonte	bisonte
borgoña	borgoña
brezo	brezo
bronce	bronce
bronceado	bronceado
burdeos	burdeos
café	café
camello	camello
canela	canela
caoba	caoba
carbón	carbón
cardenillo	cardenillo
carmesí	carmesí
carne	carne
castaña	castaña
castaño	castaño
celeste	celeste
cerceta	cerceta
chartreuse	chartreuse
chocolate	chocolate
chocolate	chocolate
cian	cian
ciruela	ciruela
cobre	cobre
cobrizo	cobrizo
color	color
colorete	colorete
coral	coral
cordobán	cordobán
crema	crema
cuero	cuero
curry	curry
dorado	dorado
espinaca	espinaca
frambuesa	frambuesa
grana	grana
gris	gris
habano	habano
hematita	hematita
hígado	hígado
jade	jade
junquillo	junquillo
kalua	kalua
latón	latón
lila	lila
lima	lima
lino	lino
lirio	lirio
llama	llama
magenta	magenta
malaquita	malaquita
malva	malva
malva	malva
marrón	marrón
melocotón	melocotón
menta	menta
miel	miel
mostaza	mostaza
musgo	musgo
naranja	naranja
negro	negro
nogal	nogal
ocre	ocre
oliva	oliva
orceína	orceína
orcela	orcela
oro	oro
palta	palta
pistacho	pistacho
porráceo	porráceo
puro	puro
púrpura	púrpura
rosado	rosado
rufo	rufo
sepia	sepia
tierra	tierra
tomate	tomate
trullo	trullo
turquesa	turquesa
turquí	turquí
verde	verde
vino	vino
violín	violín