verde	verde
azul	azul
rojo	rojo
amarillo	amarillo
gris	gris
blando	blanda
duro	dura
sencillo	sencilla
complejo	compleja
uruguayo	uruguaya
violeta	violeta
naranja	naranja
voluptuoso	voluptuosa
mayor	mayor
menor	menor
conocido	conocida
desconocido	desconocida
directo	directa
indirecto	indirecta
antiguo	antigua
moderno	moderna
normal	normal
salado	salada
dulce	dulce
diminuto	diminuta
grande	grande
ácido	ácida
seco	seca
rubio	rubia
moreno	morena
pelirrojo	pelirroja
sucio	sucia
limpio	limpia
ronco	ronca
suave	suave
rugoso	rugosa
ancho	ancha
artístico	artística
navideño	navideña
agrícola	agrícola
religioso	religiosa
consecuente	consecuente
argentino	argentina
blanco	blanca
sincero	sincera
satisfecho	satisfecha
insatisfecho	insatisfecha
fino	fina
estrecho	estrecha
caliente	caliente
frío	fría
liso	lisa
sedoso	sedosa
analítico	analítica
claro	clara
vigente	vigente
luchador	luchadora
caro	cara
barato	barata
irrompible	irrompible
indestructible	indestructible
peludo	peluda
azulado	azulada
verdoso	verdosa
escurridizo	escurridiza
estéril	estéril
líquido	líquida
sólido	sólida
realista	realista
soñador	soñadora
sinuoso	sinuosa
animado	animada
desanimado	desanimada
contento	contenta
triste	triste
amargo	amarga
salado	salada
maduro	madura
presumido	presumida
flaco	flaca
bajo	baja
alto	alta
grande	grande
pequeño	pequeña
teñido	teñida
bruto	bruta
colorido	colorida
gigante	gigante
redondo	redonda
central	central
común	común
diferente	diferente
exterior	exterior
interior	interior
joven	joven
viejo	vieja
masivo	masiva
nuevo	nueva
principal	principal
secundario	secundaria